WeChat: cstutorcs
QQ: 749389476
Email: tutorcs@163.com
1 12
WWWWWWWW
WP  W  W
W   W  W
W 1 WG W
W      W
W      W
WWWWWWWW
